NO ./sprites/1.xpm
SO ./sprites/2.xpm
WE ./sprites/3.xpm
EA ./sprites/wall.xpm

F 220,100,0
C 225,30,0

        1111111111111111111111111
        1000000000110000000000001
        1011000001110000000000001
        1001000000000000000000001
111111111011000001110000000000001
10000000001100000111011110111111
111101111111110111000000100001
111101111111110111010100100001
110000001101010111000000100001
100000000000000011000000100001
100000000000000011010100100001
110000011101010111110111100W01
11110111 1110101 1011110100001
11111111 1111111 1111111111111