NO ./sprites/wall.xpm
SO ./sprites/wall.xpm
WE ./sprites/wall.xpm
EA ./sprites/wall.xpm

F 220,100,0
C 225,30,0

111111111111111111111111
100000000000000000000001
100001000111010000000001
100001000101010000000001
100001110111011100000001
100000000000000000000001
100000000000000000000001
10000000000W000000000001
111111111111111111111111