NO ./sprites/wall.xpm
SO ./sprites/wall.xpm
WE ./sprites/wall.xpm
EA ./sprites/wall.xpm

F 220,100,0
C 225,30,0

111111111111111111111111111111111111111111111111111111111111111111
100000000000000000000000000000000000000000000000000000000000000001
100000000000000000000000000000000000000000000000000000000000000001
100000000000000000000000000000000000000000000000000000000000000001
100000111110000101010000000000000000000000000000000000000000000001
100000100010000000000000000000000000000000000000001111111000000001
100000100010000100010000000000000000000000000000001000001000000001
100000100010000000000000000000000000000000000000001011101000000001
100000110110000101010000000000000000001111111111111010101000000001
100000000000000000000000000000000000001000000000000010000000000001
100000000000000000000000000000000000011011111011111011111000000001
100000000000000000000000000000000000000000000000000000010000000001
1000000000000N0000000000000000000000011011111011011011010000000001
100000000000000000000000000000000000010000001011010000010000000001
100000000000000000000000000000000000011111101011010111110000000001
100000000000000000000000000000000000000000100000000100000000000001
111111111000000000000000000000000000000000111111111100000000000001
110100001000000000000000000000000000000000000000000000000000000001
110000101000000000000000000000000000000000000000000000000000000001
110100001000000000000000000000000000000000000000000000000000000001
110111111000000000000000000000000000000000000010001000000000000001
110000000000000000000000000000000000000000000001010000000000000001
111111111000000000000000000000000000000000000000100000000000000001
100000000000000000000000000000000000000000000001010000000000000001
100000000000000000000000000000000000000000000010001000000000000001
100000000000000000000000000000000000000000000000000000000000000001
100000000000000000000000000000000000000000000000000000000000000001
100000000000000000000000000000000000000000000000000000000000000001
100000000000000000000000000000000000000000000000000000000000000001
100000000000000000000000000000000000000000000000000000000000000001
100000000000000000000000000000000000000000000000000000000000000001
100000000000000000000000000000000000000000000000000000000000000001
100000000000000000000000000000000000000000000000000000000000000001
100000000000000000000000000000000000000000000000000000000000000001
111111111111111111111111111111111111111111111111111111111111111111