NO ./sprites/tile1.xpm
SO ./sprites/tile2.xpm
WE ./sprites/brickskin.xpm
EA ./sprites/doorwall.xpm

F 220,100,0
C 225,30,0

111111111111111111111111
100000000000000000000001
100000000000000000000001
100001011110010111100001
100000000000000000000001
100000000000000000000001
10000000000S000000000001
111111111111111111111111