NO ./textures/tile1.xpm
SO ./textures/tile2.xpm
WE ./textures/brickskin.xpm
EA ./textures/doorwall.xpm

F 50,168,82
C 126,227,247

111111111111111111111111
100000000000000000000001
100000000000000000000001
100001011110010111100001
100000000000000000000001
100000000000000000000001
10000000000E000000000001
111111111111111111111111
