NO ./sprites/wall.xpm
SO ./sprites/wall.xpm
WE ./sprites/wall.xpm
EA ./sprites/wall.xpm

F 220,100,0
C 225,30,0

        11111111111111111111111111  1
        1000000000110000000000001
        1011000001110000000000001
        10010000000000000000000001
111111111011000001110000000000001
1S1000000011000001110111111111111
11110111111111011100000010001
11110111111111011101010010001
110000001101010111000000010001
10000000000000011001000100011                           11
100000000000000001101010010001
1100000111010101111101111000111
11101111 1010101  1011010001
11111111 1111111  11111111111
                                                111